type octile
X 0
Z 0
width 32
height 32
size 4294967296
map
55555555555555555555555555555555
55555555555555555555555555555555
55555555555555555555555555555555
55555555555555555555555555555555
55555555555555555555555555555555
55555555555555555555555555555555
55555555555555555555555555555555
55555555555555555555555555555555
55555555555555555555555555555555
55555555555555555555555555555555
55555555555555555555555555555555
55555555555555555555555555555555
55555555555555555555555555555555
55555555555555555555555555555555
55555555555555555555555555555555
@@@@@@@55@@@@@@@@@@@@@@55@@@@@@@
@@@@@@@55@@@@@@@@@@@@@@55@@@@@@@
55555555555555555555555555555555
55555555555555555555555555555555
55555555555555555555555555555555
55555555555555555555555555555555
55555555555555555555555555555555
55555555555555555555555555555555
55555555555555555555555555555555
55555555555555555555555555555555
55555555555555555555555555555555
55555555555555555555555555555555
55555555555555555555555555555555
55555555555555555555555555555555
55555555555555555555555555555555
55555555555555555555555555555555
55555555555555555555555555555555
